{
  "debug": true,
  "path": "images/tileset.png",
  "tilesize": {
    "width": 16,
    "height": 16
  },
  "grid": {
    "visual": [
      [
        [],
        [],
        [],
        [],
        [],
        [],
        [],
        [-1, -1, -1, -1, -1, -1, -1, 65, 66, 67, 68, 69, -1, -1, -1, -1, -1, -1, 65, 66, 67, 68, 69],
        [-1, -1, -1, -1, -1, -1, -1, -1, 82, 83, 84, -1, -1, -1, -1, -1, -1, -1, -1, 82, 83, 84],
        [-1, -1, -1, -1, -1, -1, -1, -1, 98, 99, 100, -1, -1, -1, -1, -1, -1, -1, -1, 98, 99, 100],
        [-1, -1, -1, -1, -1, -1, -1, -1, -1, 115, -1, -1, -1, -1, -1, -1, -1, -1, -1, -1, 115],
        [-1, -1, -1, -1, -1, -1, -1, -1, -1, 131, -1, -1, -1, -1, -1, -1, -1, -1, -1, -1, 131, -1],
        [-1, -1, -1, -1, -1, -1, -1, -1, 146, 147, 148, -1, -1, -1, -1, -1, -1, -1, -1, 146, 147, 148],
        [-1, -1, -1, -1, -1, -1, -1, -1, 162, 163, 164, -1, -1, -1, -1, -1, -1, -1, -1, 162, 163, 164],
        [-1, 0, 1, 1, 1, 1, 1, 1, 1, 1, 1, 2, -1, -1, -1, -1, -1, -1, -1, 0, 1, 1, 1, 1, 1, 1, 1, 1, 1, 1, 1, 1, 1, 2]
      ]
    ],
    "logic": [
      [],
      [],
      [],
      [],
      [],
      [],
      [],
      [0, 0, 0, 0, 0, 0, 0, 1, 1, 1, 1, 1, 0, 0, 0, 0, 0, 0, 1, 1, 1, 1, 1],
      [0, 0, 0, 0, 0, 0, 0, 0, 0, 1, 0, 0, 0, 0, 0, 0, 0, 0, 0, 0, 1, 0],
      [0, 0, 0, 0, 0, 0, 0, 0, 0, 1, 0, 0, 0, 0, 0, 0, 0, 0, 0, 0, 1],
      [0, 0, 0, 0, 0, 0, 0, 0, 0, 1, 0, 0, 0, 0, 0, 0, 0, 0, 0, 0, 1],
      [0, 0, 0, 0, 0, 0, 0, 0, 0, 1, 0, 0, 0, 0, 0, 0, 0, 0, 0, 0, 1],
      [0, 0, 0, 0, 0, 0, 0, 0, 0, 1, 0, 0, 0, 0, 0, 0, 0, 0, 0, 0, 1],
      [0, 0, 0, 0, 0, 0, 0, 0, 0, 1, 0, 0, 0, 0, 0, 0, 0, 0, 0, 0, 1],
      [0, 1, 1, 1, 1, 1, 1, 1, 1, 1, 1, 1, 0, 0, 0, 0, 0, 0, 0, 1, 1, 1, 1, 1, 1, 1, 1, 1, 1, 1, 1, 1, 1, 1]
    ]
  }
}